111111111
1000C0001
101101101
1010E0101
101000101
10F000F01
1001P1001
111111111