1111111
1P0C1F1
1000001
10111F1
1C1E1C1
1000001
1111111