111111111
1F00000P1
1000C0001
100110001
100010001
1F100C101
101110001
101111111
100000FE1
111111111
