1111111
1P0C111
1010001
1011101
1C0E0C1
1111111