111111111
1CF000001
101110001
101E10001
100010001
100010001
1000111P1
100000001
111111111