111111111
1F001C0E1
100010001
100010001
111100001
1P00001C1
111111111