11111111
1P0C00F1
10111111
10111111
1E0000C1
11111111