111111111111
100000000001
100000000000
100000000001
1PCE00000001
111111111111