1111111111111
100000000 111
1PCE000000111
1111111111111
