11111111
1P0000C1
10000001
1C0000E1
1111111