11111111111111111
1FFFFFFFFFFFFFFF1
1F0000000000000F1
1F0000000000000F1
1F0000000000000F1
1F0000000000000F1
1F0000C0P000000F1
1F000000CE00000F1
1F0000000000000F1
1F0000000000000F1
1F0000000000000F1
1FFFFFFFFFFFFFFF1
11111111111111111