11111111111111111111111111111111111111111111111111111111111111111111111111111111
11P000000000000000000000000000000000000000000000000000000000000000000000000000C1
10111111111111111111111111111111111111111111111111111111111111111111111111111101
10111111111111111111111111111111111111111111111111111111111111111111111111111101
10111111111111111111111111111111111111111111111111111111111111111111111111111101
10111111111111111111111111111111111111111111111111111111111111111111111111111101
10111111110111111111111111111111111111111111111111111111111111111111111111111101
10111111111111111111111111111111111111111111111111111111111111111111111111111101
10111111111111111111111111111111111111111111111111111111111111111111111111111101
10111111111111111111111111111111111111111101111111111111111111111111111111111101
10111111111111111111111111111111111111111111111111111111111111111111111111111101
10111111111111111111111111111111111111111111111111111111111111111111111111111101
10111111111111111111111111111111111111111111111111111111111111111111111111111101
10111111111111111111111111111111111111111111111111111111111111111111111111111101
10111111111111111111111111111111111111111111111111111111111111111111111111111101
10111111111111111111111111111111111111111111111111111111111111111111111111111101
10111111111111111110111111111111111011111111111111111111111111111111111111111101
10111111111111111111111111111111111111111111111111111111111111111111111111111101
10111111111111111111111111111111111111111111111111111111111111111111111111111101
10111111111111111111111111111111111111111111111111111111111111111111111111111101
10111111111111111111111111111111111111111111111110111111111111111111111111111101
10111111111111111111111111111111111111111111111111111111111111111111111111111101
10111111111111111111111111111111111111111111111111111111111111111111111111111101
10111111111111111111111111111111111111111111111111111111111111111111111111111101
10111111111111111111111111111111111111111111111111111111111111111111111111111101
10111111111111111111111111111111111111111111111111111111111111111111111111111101
10111111111111111111111111111111111111111111111111111111111111111111111111111101
10111111111111111111111111111111111111111111111111111111111111111111111111111101
10111111111111111111111111111111111111111111111111111111111111111111111111111101
10111111111111111111111111111111111111111111111111111111111111111111111111111101
10111111111111111111111111111111111111111111111111111111111111111111111111111101
10111111111111111111111111111111111111111011111111111111111111111111111111111101
10111111111111111111111111111111111111111111111111111111111111111111111111111101
10111111111111111111111111111111111111111111111111111111111111111111111111111101
10111111111111111111111111111111111111111111111111111111111111111111111111111101
10111111111111111111111111111111111111111111111111111111111111111111111111111101
10111111111111111111111111111111111111111111111111111111111111111111111111111101
10111111111111111111111111111111111111111111111111111111111111111111111111111101
10111111111111111111111111111111111111111111111111111111111111111111111111111101
10111111111111111111111111111111111111111111111111111111111111111111111111111101
10111111111111111111111111111111111111111111111111111111111111111111111111111101
10111111111111111111111111111111111111111111111111111111111111111111111111111101
10111111111111111111111111111111111111111111111111111111111111111111111111111101
10111111111111111111111111111111111111111111111111111111111111111111111111111101
10111111111111111111111111111111111111111111111111111111111111111111111111111101
10111111111111111111111111111111111111111111111111111111111111111111111111111101
10111111111111111111111101111111111111111111111111111111111111111111111111111101
10111111111111111111111111111111111111111111111111111111111111111111111111111101
10111111111111111111111111111111111111111111111111111111111111111111111111111101
10111111111111111111111111111111111111111111111111111111111111111111111111111101
10111111111111111111111111111111111111111111111111111111111111111111111111111101
10111111111111111111111111111111111111111111111111111111111111111111111111111101
10111111111111111111111111111111111111111111111111111111111111111111111111111101
10111111111111111111111111111111111111111111111111111111111111111111111111111101
10111111111111111111111111111111111111111111111111111111111111111111111111111101
10111111111111111111111111111111111111111111111111111111111111111111111111111101
10111111111111111111111111111111111111111111111111111111111111111111111111111101
10111111111111111111111111111111111111111111111111111111111111111111111111111101
10111111111111111111111111111111111111111111111111111111111111111111111111111101
10111111111111111111111111111111111111111111111011111111111111111111111111111101
10111111111111111111111111111111111111111111111111111111111111111111111111111101
10111111111111111111111111111111111111111111111111111111111111111111111111111101
10111111111111111111111111111111111111111111111111111111111111111111111111111101
10111111111111111111111111111111111111111111111111111111111111111111111111111101
10111111111111111111111111111111111111111111111111111111111111111111111111111101
10111111111111111111111111111111111111111111111111111111111111111111111111111101
10111111111111111111111111111111111111111111111111111111111111111111111111111101
10111111111111111111111111111111111111111111111111111111111111111111111111111101
10111111111111111111111111111111111111111111111111111111111111111111111111111101
10111111111111111111111111111111111111111111111111111111111111111111111111111101
10111111111111111111111111111111111111111111111111111111111111111111111111111101
10111111111111111111111111111111111111111111111111111111111111111111111111111101
10111111111111111111111111111111111111111111111111111111111111111111111111111101
10111111111111111111111111111111111111111111111111111111111111111111111111111101
10111111111111111111111111111111111111111111111111111111111111111111111111111101
10111111111111111111111111111111111111111111111111111111111111111111111111111101
10111111111111111111111111111111111111111111111111111111111111111111111111111101
10111111111111111111111111111111111111111111111111111111111111111111111111111101
1E0000000000000000000000000000000000000000000000000000000000000000000000000000C1
11111111111111111111111111111111111111111111111111111111111111111111111111111111